10x10
1111111111
1000000001
1000000001
1000011001
1000000001
10000S0001
1000000001
1000000001
1000000001
1111111111
