10x10
1111111111
1000000001
1111000001
1000000001
1000000001
1000000001
1000011111
1000010001
1000010S01
1111111111
