10x10
1111111111
1000000001
1000000001
1000000001
1000101001
1000101001
10000S0011
1010000001
1000010001
1111111111
